Kaliyah Hahn	Anabelle Harper	Emely Cervantes	Damon Booth
Bailee Logan	Abraham Gill	Kymani Mora	Kian Welch
Lyla Oliver	Kallie Sloan	Nathanael Fernandez	Uriel Brennan
Emmanuel Hahn	Nikolai Lindsey	Jarrett Graves	Zoey Ayers
Yandel Blake	Michael Blanchard	Orion Solomon	Madyson Mullins
Micheal Harrison	Bryan Jarvis	Alexis Andersen	Kaiden Graham
Patricia Schmidt	Corey Marsh	Monique Camacho	Kendrick Jarvis
Case Parks	Amirah Norris	Michaela Byrd	Emma Serrano
Noel Fitzpatrick	Lilliana Jacobs	Blaine Todd	Joseph Salazar
Lyric House	Shaniya Parrish	Alexandra Boyer	Camren Wells
Marlon Mccarthy	Devan Davies	Kael Graham	Rishi Beasley
Jaqueline Ho	Brenton Terry	Caitlyn Khan	Iris Aguilar
Silas Buckley	Quentin Lowery	Vivian Henderson	Giada Potts
Oscar Adkins	Evan Frederick	Kelvin Hodges	Santos Jacobson
Xavier Cameron	Sam Shea	Harold Key	Laila Rocha
Cassie Stout	Dania Washington	Destiney Roberson	Bennett Barker
Addyson Madden	Maddox Reid	Josiah Wilkinson	Yair Jensen
Victoria Holloway	Arthur Wiggins	Ahmed Warner	Lina Hinton
Litzy Rivas	Lia Valenzuela	Johnathon Glover	Weston Compton
Adelaide Dodson	Julien Guzman	Paris Shaw	Richard Weeks
Esmeralda Petersen	Gavin Santana	Kaiden Ray	Mallory Rosario
Aracely Rosales	Daphne Kline	Karla Beck	Kenny Villa
Sean Jenkins	Xander Spears	Tyshawn Crosby	Lucas Bradford
Amiyah Oliver	Laura Larsen	Keenan Copeland	Alessandra Blevins
Keon Ward	Cordell Ryan	Gordon Sanford	Frankie Gibbs
Dereon Estrada	Ulises Singh	Myles Mosley	Jamarcus Donovan
Carolina Anthony	Dominique Howard	Heidy Smith	Larissa Davenport
Augustus Crane	Carlee Giles	Lamont Carney	Calvin Christian
Ashlynn Carrillo	Beau Moses	Ashlee Taylor	Kaleb Rush
Kenna Dawson	Alisa Ritter	Rayan Reilly	Austin Trujillo
Landyn Hatfield	Kaydence Pierce	Reid Castillo	Phoenix Hatfield
Deshawn Knox	Barbara Mata	Daniela Velazquez	Gabriel Wiley
Ruby Velasquez	Lee Blevins	Urijah Mccarthy	Gage Gutierrez
Amina Moyer	Maya Levy	Sonia Graham	Jacob George
Janiyah Steele	Conor Cherry	Xavier Daniel	Shayna Conley
Francisco Rice	Casey Maynard	Lola Mccormick	Jaliyah Sandoval
Jake Mosley	Walker Russell	Ryleigh Robbins	Anabel Newton
Paxton Drake	Esmeralda Walsh	Azul Barry	Gianni Perry
Marcus James	Fletcher Larson	Gianna Curtis	Rolando Alvarado
Kenya Sloan	Kassidy Frederick	Sonny Casey	Kendal Malone
Karissa Hernandez	Mireya Wright	Jayden Rose	Toby Sherman
Leo Oneill	Ross Kennedy	Kellen Arnold	Savion Hickman
Arabella Rowe	Gage Mcguire	Eduardo Fletcher	Lainey Morrow
Gillian Tapia	Hezekiah Fitzpatrick	Marissa Pena	Naima Stevenson
Diamond Davila	Zaid Krueger	Carina Decker	Liam Merritt
Joe Cannon	Bryce Leonard	Samir Gallegos	Antony Yates
Cassidy Acosta	Cynthia Bender	Jamiya Archer	Kaitlyn Carpenter
Justin Everett	Camila Bryan	Adelaide Wilcox	Kyson Shields
Marquise Kidd	Lennon Guerra	Harry Harding	Myla Greer
Edward Heath	Jazmine Gray	Hayden Craig	Devan Bailey
Ezra Michael	Johnathon Owens	Ryland Pacheco	Shamar Buchanan
Yandel Baldwin	Meadow Mccarthy	Allisson Weber	Mariana Chambers
Savanah Boone	Salvador Logan	Adrienne Prince	Devon Barrett
Shea Kelley	Nevaeh Contreras	Graham Hawkins	Madilynn Vazquez
Marc Mcmillan	Kylan Gomez	Ariana Pennington	Colten Fitzpatrick
Aiden Bullock	Joselyn Watson	Casey Perkins	Tia Burch
Santos Morse	Lea Butler	Rodolfo Stanton	Kaylah Ellison
Joanna Bonilla	Allen Browning	Nathan Cox	Ty Collier
Leila Morrow	Keegan Norman	Tomas Duke	Sophie Hahn
Amiah Cowan	Donavan Camacho	Abril Lyons	Elsie Kaufman
Kaya Galvan	Anaya Salinas	Sarahi West	Will May
Camryn Salas	Addison Pitts	Adison Horton	Jaelyn Hudson
Logan Preston	Abby Klein	Preston Clements	Kimora Callahan
Colt Cohen	Celeste Castro	Landin Sosa	Jaylee Frederick
Mary Cherry	Ayaan Valdez	Harley Massey	Brenna Craig
Holly Walter	Noel Holder	Aniyah Alvarez	Addison Rogers
Emmalee Shepherd	Kaila Hanson	Devan Burnett	Cecelia Blackwell
Alexzander Harrington	Kolby Garner	Ivy Hayes	Colin Douglas
Melissa Harrell	Ruben Huang	Cyrus Wilkins	Kallie Horn
Phoenix Roy	Kaylin Hinton	Grace Hodges	Lacey Atkinson
Cameron Ortega	Ronnie Ashley	Bailey George	Jakob Maldonado
Nataly Holden	Jazmyn Mathis	Jamiya Cline	Sebastian Richardson
Kolby Collins	Gage Savage	Randy Shelton	Anabella Giles
Jaydin Avery	Sydney Randolph	Jacqueline Berg	Kyson Black
Elisa Stafford	Lexie Welch	Dylan Pennington	Alayna Salazar
Eve Mata	Brian Osborne	Rachael Davidson	Elianna Bernard
Hayden Sloan	Frederick Vaughn	Ally Banks	Cadence Cabrera
Alivia Bowman	Toby Moon	Cael Schultz	Hallie Villanueva
Makayla Bautista	Judah Charles	Aidan Aguilar	Eli Wiggins
Deangelo Oliver	Aria Daniel	Journey Marsh	Nadia Berger
Heidi Moyer	Lyric Salinas	Hadassah Barrera	Jamal Fox
Johnathan Crawford	Billy Reed	Cloe Ortiz	Malachi Osborne
Kenny Mckee	Xzavier Alvarado	Cash Hodges	Soren Daniels
Miranda Haas	Cara Chaney	Ricky Ward	Skyler Walls
Ansley Rosales	Penelope Summers	Savannah Pope	Hunter Blankenship
Ronin Haney	Braylen Richard	Avery Lester	Brynn Horton
Kyan Briggs	Kaylyn Miles	Miles Oconnell	Kayleigh Gardner
Averie Dillon	Paisley Zhang	Drew Kane	Reese Shannon
Roberto Garza	Mya Yoder	Jaidyn Morrison	Leroy Rice
Justice Washington	Leia Bray	Mattie Maxwell	Amy Beck
Joel Fuller	Saniya Newman	Cole Ferrell	Brooks Crawford
Giovanni Beltran	Jada Mann	Marlee Daniels	Javion Jenkins
Aryanna Madden	Makai Delacruz	Ahmad Ward	Kyson Santana
Ivan Michael	Jaylen Brewer	Malaki Odonnell	Yurem Owens
Jensen Mcbride	Madeline Mora	Silas Cunningham	Chace Jones
Elaine Carter	Valentina Barr	Karly Crawford	Dillon Solomon
Carolyn Mckinney	Reginald Burgess	Osvaldo Finley	Dominique Knox
Corey Rasmussen	Paityn Lyons	Marina Blake	Aylin Pineda
Salvador Velez	Ali Wright	Milo Pace	Naima Lozano
Malik Patton	Keshawn Zamora	Alexandra Gregory	Sofia Lucas
Beatrice Brewer	Damari Kirby	Drew Waters	Marley Stevens
Camden Hahn	Luz Conley	Draven Barnes	Braedon Haas
Mira Hooper	Giovanna Ware	Chelsea Maxwell	Yasmin Mcgee
Natalya Nichols	Gemma Wilson	Christina Bowers	Savanah Vincent
Eden Good	Ibrahim Sawyer	Finn Glass	Coby Cortez
Marisol Martin	Reece Preston	Anabella Delgado	Ibrahim Ross
Belinda Cuevas	Yazmin Brennan	Elijah Moss	Oscar Martinez
Kaden Zavala	Jamari Lopez	Luca Acevedo	Callum Lowe
Amiah Wheeler	Arielle Koch	Alfred Archer	Jabari Hines
Dillan Dawson	Danny Bautista	Tobias Calderon	Jaliyah Barker
Connor Blanchard	Nyla Acevedo	Emily Moss	Marcos Carson
Ronnie Kim	Cade Brewer	Avery Hood	Audrey Ewing
Ignacio Vega	Micheal Raymond	Valentin Barker	Malakai Camacho
Carmelo Bowers	Olivia Archer	Dane Mclaughlin	Baron Merritt
Michaela Velasquez	Cyrus David	Abel Blair	Heather Pope
Misael Hendricks	Sydnee West	Annie Vega	Jamie Craig
Skyla Cooley	Joey Marks	Asia Malone	Ivy Riggs
Kayleigh Villegas	Lily Montoya	Beau Watson	Emmy Chapman
Shayna Bradshaw	Kenneth Pittman	Davion Bruce	Gemma Wu
Weston Conway	Kayla Robbins	Landon Herman	Kyla Maynard
Santos Nixon	Naomi Riggs	Clare Browning	Mary Cummings
Ryland Valentine	Steven Riddle	Jakob Bowman	Chelsea Mata
Rosa Carrillo	Shayna Thompson	Craig Brennan	Madden Patrick
Reese Gould	Arjun Owens	Madalynn Kirk	Aniya Swanson
Baron Gordon	Christian Bright	Aaron Bennett	Jaylan Wolfe
Brooke Nicholson	Antoine Forbes	Keyla Hines	Genesis Frederick
Tristan Leonard	Harmony Faulkner	Natasha Frye	Julius Norris
Amanda Church	Alexia Kline	Izayah Knapp	Shelby Jimenez
Tamia Moses	Abram Ray	Shawn Mullins	Marc Lynch
Mina Sexton	Asa Whitney	Adrian Haas	Lindsay Benson
Kobe Peck	Emilio Walsh	Campbell May	Sarah Gallagher
Cornelius Choi	Brandon Griffith	Destiny Frank	Miya Barr
Cassandra Orr	Camron Glass	Santino Travis	Bradley Hampton
Beckham Tate	Richard Hardin	Marley Hartman	Bennett Villanueva
Giada Garza	Stanley Parsons	Kaylah Velasquez	Ellen Carrillo
Charlie Decker	Amina Parks	Kaleigh Garza	Ireland Rogers
Jaycee Baldwin	Lauren Bates	Viviana Wong	Sanaa Ochoa
Paloma Holden	Teagan Mccormick	Camren Howard	Courtney Montgomery
Adeline Collins	Lorenzo Maynard	Willow Mays	Marilyn Davenport
Ross Walton	Bailee Cantrell	Eliezer Mccarty	Jameson Perez
Lilian Ferrell	Jagger Figueroa	Teresa Miller	Joy Ellis
Mallory Clarke	Aylin Morgan	Cade Brock	Clay Spencer
Octavio Palmer	Caitlin Mcdaniel	Louis Wilkerson	Yandel Horne
Natalia Lyons	Desiree Clayton	Juan Mayer	Ignacio Guerrero
Charlize Ali	Cedric Duffy	Maliyah Roach	Mckayla Grimes
Skye Huang	Sonia Vaughan	Piper Robles	Camden Olson
Gracie Michael	Emanuel Ware	Judah Dougherty	Lucas Fowler
Destinee Gentry	Darion Gates	Hudson Moss	Ayla Robertson
Luke Turner	Bruce Short	Duncan Schmitt	Patrick Hodge
Austin Montoya	Cheyanne Dillon	Larry Rodgers	Kathleen Sweeney
Ayanna Goodwin	Lauren Orozco	Calvin Guerrero	Katrina Duffy
Maxwell Davidson	Taliyah Gonzalez	Charlee Dyer	Imani Bates
Kayden Ball	Crystal Cherry	Leon Sampson	Rayna Russell
Jameson Watts	Bianca Stokes	Jaylene Patton	Meadow Jennings
Kassandra Mata	Beckham Knapp	Mallory Perkins	Sophie Spencer
Krista Molina	Phoenix Rice	Gracie Rogers	Faith Bowman
Jordyn Fowler	Janelle Grimes	Ayla Eaton	Jaylin Norris
Leonidas Mclean	Jasmin Nielsen	Finley Davies	Joaquin Warner
Ayaan Perry	Jaylen Bradford	Cash Benitez	Fisher Stokes
Peyton Webb	Solomon Good	Jonah Taylor	Hailey Perry
Frida Macias	Cora Bush	Kelton Cline	Kiera Jones
Aisha Deleon	Ronnie Hunt	Elliot Petty	Rene Villarreal
Carlo Bray	Noelle Powers	Emilio Kirby	Lincoln Anthony
Brooke Ray	Marley Rosario	Calvin Simpson	Yaretzi Vincent
Agustin Riggs	Litzy Nelson	Janiyah Perkins	Jazlyn Mcmillan
Fisher Schneider	Romeo Hood	Melina Bowman	Haven Shaffer
Alondra Guerra	Jayvion Hoffman	Alani Mcguire	Katherine Arnold
Jaida Griffith	Khloe Schwartz	Hugo Rojas	Mayra Cooley
Tabitha Weiss	Rigoberto Ferguson	Darion Collins	Evelin Buck
Micah Sawyer	Felicity Walters	Javon Gould	Alexander Callahan
Paloma Farmer	Summer Carr	Jonathan Chang	Denise Murillo
Tessa Zamora	Houston Maldonado	Amaya Higgins	Isai Mitchell
Scarlet Reese	Emmett Jones	Kymani Holt	Antony Everett
Magdalena Dorsey	Santos Bridges	Owen Hodges	Jan Kramer
Peyton Travis	Yosef Rivas	Gage Hammond	Carlo Zimmerman
Jaidyn Stewart	Eliezer Hicks	Carsen Wagner	Kelton Curtis
Roberto Gardner	Kamren Kim	Sawyer Booker	Peyton Knox
Austin Pacheco	Adeline Gould	Reynaldo Meadows	Abbie Ayers
Kellen Chase	Howard Shaffer	Pierre Huerta	Alvaro Lindsey
Ruby Patel	Finn Reid	Ramon Hooper	Ryan Rich
Akira House	Josephine Rios	Lilian Hahn	Giada Huffman
Karley Khan	Billy Adkins	Destinee Blair	Marissa Becker
Memphis Cannon	Marcelo Bullock	Kareem Moon	Sterling Kane
Dominique Velasquez	Makhi Zhang	Jase Cruz	Sienna Hodges
Kaylen Murphy	Haylie Galloway	Hailee Hughes	Tyshawn West
Jayvion Buchanan	Landen Payne	Sophie Chapman	Jude Roberson
Dania Friedman	Justine Harper	Tristen Shaffer	Ronnie Mclaughlin
Kianna Vaughn	Alonso Cobb	Addisyn Dillon	Alisa Ross
Tristian Long	Kamila Friedman	Kash Rollins	Stacy George
Tripp Maddox	Mary Humphrey	Reese Tran	Ashton Carr
Isis Davenport	Lorenzo Dunlap	Hadley Ponce	Jovan Stevenson
Haven Lowery	Talon Villanueva	Evangeline Jensen	Peyton Nielsen
Adyson Duncan	Journey Mack	Leroy Mooney	Jaylah Knapp
Emiliano Acevedo	Larry Gilbert	Danielle Park	Declan Proctor
Micah Bean	Edward Reilly	Conor Cantu	Valerie Oneal
Sam Carroll	Alonso Wheeler	Carissa Malone	Erin Ali
Roy Bowers	Evangeline Proctor	Mina Stuart	Nathalie Nicholson
Jaylin Mcknight	Christian Blankenship	Kieran Stuart	Julianna Dickerson
Sophia Ferguson	Waylon Mcclure	Kaila Bonilla	Anika Mckenzie
Jennifer Osborne	Holden Ibarra	Kane Wu	Kristin Haley
Jaden Hooper	Regan Mckee	Fabian Blackwell	Cloe Taylor
Emely Osborne	Diamond Ingram	Konner Riggs	Malik Doyle
Kaila Fox	Eduardo Matthews	Jovanni Wong	Mattie Huff
Maximilian Nunez	Neveah Yates	Hunter Stevens	Giovanny Huffman
Mariana Jenkins	Charlee Estrada	Alana Barnes	John Briggs
Sean Baxter	Yahir Davidson	Zavier Medina	Sariah Cantrell
Francis Haynes	Roger Boyd	Elliot Schmidt	Kaylynn Barajas
Hailie Watson	Frederick Richmond	Lesly Pena	Martin Bird
Blake Munoz	Lillie Chambers	Vicente Stevenson	Angela White
Enrique Peterson	King Gentry	Lizeth David	Ann Gillespie
Shamar Maddox	Christina Mccoy	Mario Acevedo	Jaycee Lloyd
Jaquan Mason	Khalil Yang	Emilie Huber	Makhi Alexander
Juliet Whitehead	Humberto James	Taliyah Donovan	Crystal Knight
Alvin Gates	Esther Schmidt	Derrick Alexander	Brenton Brock
Issac Jefferson	Rory Castro	Laurel Crane	Joanna Poole
Alonso Roach	Rachel Love	Philip Yoder	Frances Wiggins
Piper Gilbert	Skylar Fitzgerald	Cloe Reeves	Emilie Castaneda
Phoenix Collier	Adriana Velez	Jazmyn Campbell	Teagan Garza
Josiah Kerr	Abby Lynch	Alissa Conley	Leo Hayden
Shyann Wilson	Jesse Spears	Aden Lucas	Leslie Dawson
Ana Johns	Weston Mcclain	Marley Davenport	Raiden Irwin
David Mckay	Junior Frye	Makayla Joyce	Santiago Carter
Mariana Young	Joey French	Karter Byrd	Mia Osborn
Isai Rose	Fabian Yates	Elsa Andersen	Mario Vega
Kayden Nicholson	Brent Zavala	Anya Wilkerson	Santos Moore
Alannah Shaw	Mikaela Padilla	Alexandra Mullen	Damian Flynn
Clark Bridges	Adyson Waters	Jase Rosales	Kamron Simpson
Jamie Faulkner	Finnegan Frazier	Trent Cain	Lewis Chan
Branden Shepherd	Roy Galvan	Danica Schneider	Trystan Singh
Dominick Watkins	Penelope Robinson	Valentino Rivas	Jaxon Griffin
Evan Reese	Anabelle Schwartz	Damarion Beck	Milo Booth
David Dominguez	Joey Perez	Valentin English	Shane Bright
Precious Cline	Griffin Giles	Nasir Hendrix	Draven Bonilla
Andrew Mullins	Jayleen Shepard	Erin Tate	Phoebe Mcgee
Milagros Orozco	Rebecca Acevedo	Sherlyn Bernard	Carla Richard
Desmond Love	Hallie Rowe	Cayden Frank	Roger Harper
Mikaela Santiago	Cameron Cooley	Nathan Krause	Tara Ali
Reginald Colon	Donald Simmons	Brisa Bautista	Kamden Rice
Caden Hogan	Kaylee Buchanan	Kenzie Kerr	Cullen Cortez
Monica Brock	Ann Doyle	Amanda Friedman	Bobby Edwards
Damion Hoover	Ava Cherry	Kennedi Jensen	Denisse Wiley
Parker Forbes	Maxwell Vaughan	Rosa Travis	Kaitlin Miles
Dwayne Chandler	Ana Cline	Juliana Huang	Jaxon Kirby
Tyson Bonilla	Matteo Edwards	Ray Gibbs	Memphis Harrington
Levi Cantu	Alexzander Potter	Yael Marquez	Tyrone Briggs
Tamara Mercer	Jayla Hanna	Ryan Chaney	Henry Mosley
Valerie Mccarthy	Erica Hampton	Ralph Mcknight	Bailey Dominguez
Natalie Short	Jazlyn Burch	Elliott Mclean	Shaylee Nielsen
Stanley Sparks	Bradley Johnston	Baron Callahan	Simon Baxter
America Kidd	Aron Krueger	Amani Burch	Hugo Webster